
###############################################################################                                                                         
#                                                                              #
#                                                                              #
#                                                                              # 
#                                                                              #
#                                                                              #
#                                                                              #
#                                                                              #
#                                                                              #
#                                                                              #
#                                                                              #
#                                                                              #
#                                                                              #
#                                                                              #
#                                                                              #
#                                                                              #
#                                                                              #
#                                                                              #
#                                                                              #
#                                                                              # 
#                                                                              #
#                                                                              #
###############################################################################