............................#................................................
............................#................................................
............................#................................................
............................#................................................
............................#................................................
............................#................................................
............................#................................................
............................#......##########################################
............................#................................................
............................#................................................
............................#...............#................................
............................................#................................
............................................#................................
#######################################.....#................................
............................................#................................
............................................#................................
............................................#................................
............................................#................................
............................................#................................
............................................#................................
............................................#................................
