##########################........................###########################
#........................#........................#.........................#
#........................#........................#.........................#
#........................#........................#.........................#
#........................#........................#.........................#
#........................##########################.........................#
#...........................................................................#
#...........................................................................#
##################.........................................##################
.................#...........................................................
.................#...........................................................
.................#...........................................................
##################.........................................##################
#...........................................................................#
#...........................................................................#
#...........................................................................#
#........................#........................#.........................#
#........................#........................#.........................#
#........................#........................#.........................#
#........................#........................#.........................#
##########################........................###########################
